2 0 	 4 0 	 0 -1 	 0 -1 	0 -1	 0 -1	 0 -1 


3 0	 6 0	 0 -1	 0 -1 	0 -1	 0 -1	 0 -1 


0 -1	 0 -1 	 0 -1 	 0 -1 	0 -1 	 0 -1	 0 -1


0 -1	 0 -1	 0 -1 	 0 -1	0 -1 	 0 -1 	 0 -1

0 -1	 0 -1	 0 -1	 0 -1 	0 -1	 0 -1	 0
 -1

0 -1 	 0 -1 	 0 -1 	 0 -1 	0 -1	 3 1 	 2 1

0 -1 	 0 -1 	 0 -1 	 0 -1 	0 -1 	 1 0 	 3 1